    NO  ./textures_xpm/naturalbricks_hd_verydark.xpm

   
SO ./textures_xpm/naturalbricks_hd_verydark.xpm
       EA   ./textures_xpm/naturalbricks_hd_verydark.xpm
         
        



    WE         ./textures_xpm/naturalbricks_hd_verydark.xpm

   C    155   ,  100  ,  160
   F 111 , 111  ,111   1

11111111111111111
10000000000000001
101000001000001011
10000000000000001
11111111111111111
10001000100010001
10000000000000001
10101010E01010101
10000000000000001
10001000100100001
10000000000000001
10100000100001001
10000000000000001
11111111111111111