NO  ./executer/images/east.xpm   
SO ./executer/images/west.xpm
EA ./executer/images/north.xpm
WE  ./executer/images/south.xpm
C  155      ,  100    ,  160
F  111  ,  111  ,   111

11111111111111111111
10000000000000000001
110000000010000000001
10000000010000000001
10000000000000000001
1000000000N000000001
10001000000010000001
10000000000000000001
11111111111111111111