NO  ./executer/images/east.xpm   
SO ./executer/images/west.xpm
EA ./executer/images/north.xpm
WE ./executer/images/south.xpm
C  155  ,  100    ,  160
F  111  ,  111  ,   111

         1111111111111111111111111
        1000000000110000000000001
        1000000000110000000000001
        1011000001110000000000001
        100100100000000S010001001
11111111101100000111000000000001
11111111101100000111000000000001
11111111101100000111000000000001
100000000011000001110111111111111
11110111111111011100000010001 
11110111111111011101010010001 
11000000110101011100000010001
100000000000000001101000010001
100000000000000000000000000001
1100000111011101111101111000111
11110111 1110101 101111010001
11111111 1111111 111111111111