
C 0,255,255
NO ./executer/images/north.xpm
SO ./executer/images/south.xpm
WE ./executer/images/west.xpm
EA ./executer/images/east.xpm
F 0,128,0

 11111111111111111
1111111111111111111
1000000001000000001
1000E00000100000001
1001000000000000001
1000000000010000001
1000000000100000001
 11111111111111111




 