    NO  ./executer/images/north.xpm
   
SO ./executer/images/south.xpm
       EA   ./executer/images/east.xpm
         
        



    WE         ./executer/images/west.xpm

   C    155   ,  100  ,  160
   F 111 , 111  ,111

11111111111111111
10000000000000001
101000001000001011
10000000000000001
11111111111111111
10001000100010001
10000000000000001
10101010001010101
10000000000000001
10001000100100001
10000000000000001
10100000100001001
10000W00000000001
11111111111111111