NO  ./executer/images/east.xpm   
SO ./executer/images/west.xpm
EA ./executer/images/north.xpm
WE  ./executer/images/south.xpm
C  155      ,  100    ,  160
F  111  ,  111  ,   111

  1
1 11
11N11
 1011
1001
10011
11111