
C 225,100,10
NO ./executer/images/Ground.xpm 
SO ./executer/images/green.xpm
WE ./path_to_the_west_texture
EA    ./path_to_the_east_texture
F 255,100,255


1111111111111111111111
1001000000001000000001
1001000000000100000001
1001000000000010000001
1001000000000001000001
1001000000000N00100001
1001000000000000010001
1001000000000000001001
1010000000000000000101
1100000000000000000011
1111111111111111111111
