C 225,100,10
NO ./executer/images/ground.xpm 
SO ./executer/images/green.xpm
WE ./path_to_the_west_texture
EA ./path_to_the_east_texture
F 255,100,255


1111111111111111111111
1001000000000000000001
1001000000000000000001
1001000000000000000001
1001000000000000000001
1001000000000000000001
1001000000000000000001
1001000000000000000001
1010000000000000000001
1100N00000000000000001
1111111111111111111111